11111111111111111111111111
1...........11...........1
1.1111.1111.11.1111.1111.1
1.1111.1111.11.1111.1111.1
1.1111.1111.11.1111.1111.1
1...........C............1
1.1111.1.11111111.1.1111.1
1......1....11....1......1
111111.1111.11.1111.111111
111111.1..........1.111111
111111.1.111..111.1.111111
1........1......1.......E1
111111.1.11111111.1.111111
111111.1..........1.111111
111111.1.11111111.1.111111
1...........11...........1
1.1111.1111.11.1111.1111.1
1...11.......P......11...1
111.11.1.11111111.1.11.111
1......1....11....1......1
1.111111111.11.111111111.1
1........................1
11111111111111111111111111
