1111111
1000001
100P001
1000111
1C001E1
1111111
