11111111111111111111111111
10000000000000000000010001
10000000000000000000100001
10000000000000000001000001
10000000000000000010000001
100000C0000011100100000001
10000000000000001000000001
10000000000000010000000001
10000000000000100000000001
10000000000001000000000001
10000000000010000000000001
10001000000100000000000001
10000000001000000000000001
10000000010000000000000001
10000000000000000000000001
10000001000000000000000001
10000010000000000000000001
1000010000000000E000000001
1000100C000000000000000001
10010000000000000000000001
11100000000000000000000001
1P000000000000000000000001
11111111111111111111111111
