111111111111
1E0000000001
11001d000001
100111100001
100000100001
100100d00001
1001d1100001
100000000001
100000001001
100000010001
100000100001
111111111111
