NO ./textures/stonewall.xpm
WE ./textures/stonewall_dark.xpm   
EA ./textures/stonewall_dark.xpm
SO ./textures/stonewall.xpm

                F 1, 100, 1    
      C 105,3a0,200      

        1111111111111111111111111
        1000000000110000010001001
        1011000001110001010100001
        1001000000000001000101001
111111111011000001110000010000001
100000000011000001110111111111111
111101111111110101000000100011111
111101111111110101010100000011
1100000011010101010000001000111
10000E000000001000000001000111
100100000000000011010100100001111
1100000111010101111101111000111111111
11100111 1110101 10111101000000000001
11111111 1111111 11111111111111111111
